25 10
#########################
#                       #
#   ########            #
#                  *    #
#   ############        #
#   #                   #
#   #                   #
#   #####               #
#                       #
#########################
