29 13
#############################
#   ####                  ###
#                           #
#   #####                   #
#                           #
#           ######          #
#           #               #
# #######   #       #####   #
# #  *       #              #
# ###########               #
# #                         #
# #                         #
#############################
