14 10
##############
#            #
#     #      #
#     #  #   #
#     #  #   #
#     #  #   #
#     ####   #
#   *        #
#            #
##############
