29 13
#############################
#                        #  #
#                        #  #
#        #######         #  #
#     ##############     #  #
#      # ########        #  #
#      # *  #            #  #
#      #    #       ######  #
#      #    #        #      #
#           #        #    ###
#                           #
#                           #
#############################
