40 10
########################################
#                                      #
#  ###                     ####   ###  #
#             ###  ###                 #
#    #######  #   *  #                 #
#             #      #   ########      #
#             ########                 #
#  ###                   ####      ### #
#                                      #
########################################
